E1111111111
1111111C111
P1111111111