1111111111111111111111
11111111111000000000000000111
1111111110000000000000000000001
111111111000000000000000000000001
1111111100000000000000000000000001
111111110000000000000C000000000001
1111111100000000000000000000000001
11111111000000000000P00000000001
1111111110000000000000000000001
111111111100000000E0000000111
111111111111111111111111