11111111111
1E000000001
10000100C01
1P000000001