11111111111
1E000000000
10000100C01
1P000000001
11111111111