        1111111111111
    111000000000000000111
   10000000000000000000001
  1000000000000000000000001
 100000000000000000000000001
 10000000000200C000000000001
 100000000000000000000000001
  1000000000000P00000000001
   10000000000000000000001
    11100000000E0000000111
        11111111111111